...E........S
a............
.............
............a
.............