###############
xxxE#.........#
x####.#####.#.#
x.......#.#....
x#######.......
x...#..........
x...#..........
x...#.##..#####
x####.#..##xxxx
x#xxxx#....x##S
xxx#.xxxxxxx..#
