EX############.S
.X..#.....#..#oX
#X.....#.....#..
#X####.#######..
#XXXo#..........
