E.############.S
....#.....#.o#o.
#......#.....#..
#.####.#######..
#....#..........
