###############
...E#.........#
.####.#####.#.#
........#.#....
.#######.......
....#..........
....#..........
....#.##..#####
.####.#..##....
.#....#.....##S
...#..........#