E.############.S
....#S....#..#o.
#......#.....#..
#.####.#######..
#...o#..........

SSSS