S.......
....#...
...S#...
..###...
.......E