E.############.S
....#.....#..#o.
#......#.....#..
#.####.#######..
#...o#..........